28 28 28 28 28 28 28 28 28 28 28 28 28 28 28 28 28 28 28 28 28 28 28 28 28 28 28 28 28 28 28 28 28 28 28 28 28 28 28 28 28 28 28 28 28 28 28 28 28 28 28 28 28 28 28 28 28 28 28 28 28 28 28 28 28 28 28 28 28 28 28 28 28 28 28 28 28 28 28 28 28 28 28 28 28 28 28 28 28 28 28 28 28 28 28 28 28 28 28 28
28 28 28 28 28 28 28 28 28 28 28 28 28 28 28 28 28 28 28 28 28 28 28 28 28 28 28 28 28 28 28 28 28 28 28 28 28 28 28 28 28 28 28 28 28 28 28 28 28 28 28 28 28 28 28 28 28 28 28 28 28 28 28 28 28 28 28 28 28 28 28 28 28 28 28 28 28 30 30 30 30 30 30 30 30 30 30 30 30 30 30 30 28 28 28 28 28 28 28 28
28 28 28 28 28 28 28 28 28 28 28 28 28 28 28 28 28 28 28 28 28 28 28 28 28 28 28 28 28 28 28 28 28 28 28 28 28 28 28 28 28 28 28 28 28 28 28 28 28 28 28 28 28 28 28 28 28 28 28 28 28 28 28 28 28 28 28 28 28 28 28 28 28 28 28 28 30 30 19 19	19 19 19 19 19 19 19 19 19 19 19 30 28 28 28 28 28 28 28 28
28 28 28 28 28 28 28 28 28 28 28 28 28 28 28 28 28 28 28 28 28 28 28 28 28 28 28 28 28 28 28 28 28 28 28 28 28 28 28 28 28 28 28 28 28 28 28 28 28 28 28 28 28 28 28 28 28 28 28 28 28 28 28 28 28 28 28 28 28 28 28 28 28 28 28 30 30 19 20 20	20 20 20 20 20 20 20 20 20 20 20 20 19 30 30 28 28 28 28 28
28 28 28 28 28 28 28 28 28 28 28 28 28 28 28 28 28 28 28 28 28 28 28 28 28 28 28 28 28 28 28 28 28 28 28 28 28 28 28 28 28 28 28 28 28 28 28 28 28 28 28 28 28 28 28 28 28 28 28 28 28 28 28 28 28 28 28 28 28 28 28 28 28 28 30 30 19 20 20 20 23 23 23 23 23 23 23 23 23 23 20 20 20 19 30 30 28 28 28 28
28 28 28 28 28 28 28 28 28 28 28 28 28 28 28 28 28 28 28 28 28 28 28 28 28 28 28 28 28 28 28 28 28 28 28 28 28 28 28 28 28 28 28 28 28 28 28 28 28 28 28 28 28 28 28 28 28 28 28 28 28 28 28 28 28 28 28 28 28 28 28 28 28 30 30 19 19 20 20 23 10 10 10 10 10 10 10 10 10 10 23 20 20 19 19 30 30 28 28 28
28 28 28 28 28 28 28 28 28 28 28 28 28 28 28 28 28 28 28 28 28 28 28 28 28 28 28 28 28 28 28 28 28 28 28 28 28 28 28 28 28 28 28 28 28 28 28 28 28 28 28 28 28 28 28 28 28 28 28 28 28 28 28 28 28 28 28 28 28 28 28 28 28 30 19 20 20 20 23 10 10 10 10 11 11 11 10 10 10 10 10 23 20 20 19 19 30 30 28 28
28 28 28 28 28 28 28 28 28 28 28 28 28 28 28 28 28 28 28 28 28 28 28 28 28 28 28 28 28 28 28 28 28 28 28 28 28 28 28 28 28 28 28 28 28 28 28 28 28 28 28 28 28 28 28 28 28 28 28 28 28 28 28 28 28 28 28 28 28 28 28 28 30 30 20 19 19 23 10 10 10 10 11 11 10 11 10 10 10 11 10 10 23 20 20 20 19 30 28 28
28 28 28 28 28 28 28 28 28 28 28 28 28 28 28 28 28 28 28 28 28 28 28 28 28 28 28 28 28 28 28 28 28 28 28 28 28 28 28 28 28 28 28 28 28 28 28 28 28 28 28 28 28 28 28 28 28 28 28 28 28 28 28 28 28 28 28 28 28 28 28 28 30 19 20 20 23 10 10 11 11 10 10 10 10 10 10 10 10 11 11 10 10 23 20 20 19 30 28 28
28 28 28 28 28 28 28 28 28 28 28 28 28 28 28 28 28 28 28 28 28 28 28 28 28 28 28 28 28 28 28 28 28 28 28 28 28 28 28 28 28 28 28 28 28 28 28 28 28 28 28 28 28 28 28 28 28 28 28 28 28 28 28 28 28 28 28 28 28 28 28 30 30 19 19 23 10 10 10 12 10 10 10 10 10 10 10 10 10 11 11 10 10 10 23 20 19 19 33 28
28 28 28 28 28 28 28 28 28 28 28 28 28 28 28 28 28 28 28 28 28 28 28 28 28 28 28 28 28 28 28 28 28 28 28 28 28 28 28 28 28 28 28 28 28 28 28 28 28 28 28 28 28 28 28 28 28 28 28 28 28 28 28 28 28 28 28 28 28 28 28 33 19 20 20 23 10 10 10 10 22 22 22 10 10 10 10 22 22 22 11 11 10 10 23 20 20 19 30 28
28 28 28 28 28 28 28 28 28 28 28 28 28 28 28 28 28 28 28 28 28 28 28 28 28 28 28 28 28 28 28 28 28 28 28 28 28 28 28 28 28 28 28 28 28 28 28 28 28 28 28 28 28 28 28 28 28 28 28 28 28 28 28 28 28 28 28 28 28 28 28 31 19 20 20 23 11 10 10 10 22 22 22 10 10 10 10 22 22 22 10 11 11 11 23 20 20 19 32 28
28 28 28 28 28 28 28 28 28 28 28 28 28 28 28 28 28 28 28 28 28 28 28 28 28 28 28 28 28 28 28 28 28 28 28 28 28 28 28 28 28 28 28 28 28 28 28 28 28 28 28 28 28 28 28 28 28 28 28 28 28 28 28 28 28 28 28 28 28 28 28 31 19 20 20 23 10 11 10 10 22 22 22 10 10 10 10 22 22 22 10 12 12 10 23 20 20 19 32 28
28 28 28 28 28 28 28 28 28 28 28 28 28 28 28 28 28 28 28 28 28 28 28 28 28 28 28 28 28 28 28 28 28 28 28 28 28 28 28 28 28 28 28 28 28 28 25 25 28 28 28 28 28 28 28 28 28 28 28 28 28 28 28 28 28 28 28 28 28 28 28 31 31 19 20 23 10 12 10 10 10 10 10 10 10 10 12 12 12 12 12 12 12 10 23 20 19 19 32 28
28 28 28 28 28 28 28 28 28 28 28 28 28 28 28 28 28 28 28 28 28 28 28 28 28 28 28 28 28 28 28 28 28 28 28 28 28 28 25 25 25 25 25 25 25 25 25 25 25 25 25 25 25 25 28 28 28 28 28 28 28 28 28 28 28 28 28 28 28 28 28 28 31 19 20 20 23 12 12 11 11 10 11 11 12 12 12 10 10 10 12 11 10 23 20 20 19 32 32 28
28 28 28 28 28 28 28 28 28 28 28 28 28 28 28 28 28 28 28 28 28 28 28 28 28 28 25 25 25 25 25 25 25 25 25 25 25 25 25 25 25 25 25 25 25 25 25 25 25 25 25 25 25 25 25 25 25 28 28 28 28 28 28 28 28 28 28 28 28 28 28 28 31 31 19 20 20 23 12 12 11 11 11 10 12 12 10 11 11 11 10 10 23 20 20 19 19 30 30 28
28 28 28 28 28 28 28 28 28 28 28 28 28 28 28 28 28 28 28 28 25 25 25 25 25 25 25 25 25 25 25 25 25 25 25 25 25 25 25 25 25 25 25 25 25 25 25 25 25 25 25 25 25 25 25 25 25 25 25 25 28 28 28 28 28 28 28 28 28 28 28 28 31 33 30 19 20 20 23 10 10 11 11 10 10 12 10 10 10 10 10 23 20 20 19 19 19 30 28 28
28 28 28 28 28 28 28 28 28 28 28 28 28 28 28 28 28 25 25 25 25 25 25 25 25 25 25 25 25 25 25 25 25 25 25 25 25 25 25 25 25 25 25 25 25 25 25 25 25 25 25 25 25 25 25 25 25 25 25 25 25 25 25 25 25 28 28 25 25 28 28 28 28 31 33 30 19 20 20 23 12 10 11 11 11 10 10 11 11 12 23 20 20 19 19 32 32 28 28 28
28 28 28 28 28 28 28 28 28 28 28 28 28 28 28 25 25 25 25 25 25 25 25 25 25 25 25 25 25 25 25 25 25 25 25 25 25 25 25 25 25 25 25 25 25 25 25 25 25 25 25 25 25 25 25 25 25 25 25 25 25 25 25 25 25 25 25 25 25 25 25 25 25 31 31 31 19 19 20 23 12 12 12 10 11 11 11 11 12 12 23 20 19 19 25 25 25 25 25 28
28 28 28 28 28 28 28 28 28 28 28 28 28 25 25 25 25 25 25 25 25 25 25 25 25 25 25 25 25 25 25 25 25 25 25 25 25 25 25 25 25 25 25 25 25 25 25 25 25 25 25 25 25 25 25 25 25 25 25 25 25 25 25 25 25 25 25 25 25 25 25 25 25 25 25 31 31 19 20 23 23 23 23 12 12 12 10 23 23 23 23 20 19 25 25 25 14 14 14 14
28 28 28 28 28 28 28 28 28 28 25 25 25 25 25 25 25 25 25 25 25 25 25 25 25 25 25 25 25 25 25 25 25 25 25 25 25 25 25 25 25 25 25 25 25 25 25 25 25 25 25 25 25 25 25 25 25 25 25 25 25 25 25 25 25 25 25 25 25 25 25 25 25 25 25 31 31 19 19 20 20 20 20 10 10 10 10 20 20 20 20 20 25 25 25 14 19 19 19 14
28 28 28 28 28 28 28 28 25 25 25 25 25 25 25 25 25 25 25 25 25 25 25 25 25 25 25 25 25 25 25 25 25 25 25 25 25 25 25 25 14 14 14 14 14 14 14 25 25 25 25 25 25 25 25 25 25 25 25 25 25 25 25 25 25 25 25 25 25 25 25 25 25 25 25 25 25 31 19 19 20 20 20 20 20 20 20 20 20 25 25 25 25 25 14 19 26 26 26 19
28 28 28 28 28 25 25 25 25 25 25 25 25 25 25 25 25 25 25 25 25 25 14 14 14 14 14 25 25 25 25 25 25 25 25 25 25 25 14 14 14 14 14 14 14 14 14 14 25 25 25 25 25 25 25 25 25 25 25 25 25 25 25 25 25 25 25 25 25 25 25 25 25 25 25 25 25 31 31 31 14 14 20 20 20 20 20 20 25 25 25 25 25 14 14 14 19 26 19 14
28 28 25 25 25 25 25 25 25 25 25 25 25 25 25 25 25 25 25 25 25 14 14 14 14 14 14 14 14 25 25 25 25 25 25 25 25 14 14 17 17 17 17 17 17 17 14 14 14 14 25 25 25 25 25 25 25 25 25 25 21 21 21 21 21 21 21 21 21 21 21 21 21 21 21 21 21 25 25 25 14 14 14 14 17 17 17 17 17 17 17 17 17 14 14 17 17 19 17 17
25 25 25 25 25 25 25 25 25 25 25 25 25 25 25 25 25 25 25 25 14 14 14 17 17 17 17 14 14 25 25 25 25 25 25 25 14 14 17 17 29 29 29 29 29 29 29 14 14 14 25 25 25 25 25 25 25 25 25 25 21 18 18 18 18 18 18 18 18 18 21 18 18 18 18 18 21 25 25 25 25 25 25 14 14 14 14 14 14 14 17 17 17 17 17 17 17 17 17 25
25 25 25 25 25 25 25 25 25 25 25 25 25 25 25 25 25 25 25 14 14 14 17 17 17 17 17 14 14 14 25 25 25 25 25 25 14 17 17 29 29 29 26 26 26 26 29 29 14 14 25 25 25 25 25 25 25 25 25 25 21 18 18 21 21 21 21 21 18 18 21 18 21 21 21 18 21 25 25 25 25 25 25 25 25 25 25 25 14 14 14 14 14 14 14 34 17 17 34 25
25 25 25 25 25 25 25 25 25 25 25 25 25 25 25 25 25 25 25 14 14 14 17 17 17 17 17 17 14 14 25 25 25 25 25 25 14 17 17 29 29 26 26 26 26 26 26 26 26 14 25 25 25 25 25 25 25 25 25 25 21 18 18 18 18 18 18 21 18 18 21 18 21 18 21 18 21 25 25 25 25 25 25 25 34 34 34 34 34 34 34 34 34 34 34 34 16 16 34 25
25 25 25 25 25 25 25 25 25 25 25 25 25 25 25 25 25 25 25 14 14 14 17 17 17 17 17 17 14 14 25 25 25 25 25 25 14 17 17 29 29 26 26 26 26 26 26 26 26 14 25 25 25 25 25 25 25 25 14 14 21 18 18 18 18 18 18 21 18 18 21 18 18 18 21 18 21 25 25 25 25 25 34 34 34 15 16 15 15 15 15 15 15 15 15 16 16 16 34 25
25 25 25 25 25 25 25 25 25 25 25 25 25 25 25 25 25 25 25 14 14 14 17 17 17 17 17 17 14 14 25 25 25 25 25 25 14 17 17 29 29 29 26 26 26 26 26 26 26 14 25 25 25 25 25 25 25 25 14 19 21 21 21 21 21 18 18 21 18 18 21 21 21 21 21 18 21 25 25 25 34 34 34 15 15 16 16 15 34 34 34 15 15 16 16 16 15 15 34 25
25 25 25 25 25 25 25 25 25 25 25 25 25 25 25 25 25 25 25 25 14 14 14 14 17 17 17 14 14 14 25 25 25 25 25 25 25 14 17 29 29 29 29 26 26 26 26 26 14 14 25 25 25 25 25 25 25 14 19 19 18 18 18 18 18 18 18 21 18 18 18 18 18 18 18 18 21 25 25 25 34 15 16 16 15 24 34 34 34 34 34 15 15 15 34 34 34 34 34 25
25 25 25 25 25 25 25 25 25 25 25 25 25 25 25 25 25 25 25 25 25 25 14 14 14 17 17 14 14 14 25 25 25 25 25 25 25 14 14 17 17 29 29 29 29 29 29 14 14 25 25 25 25 25 25 25 25 14 19 19 18 18 18 18 18 18 18 21 18 18 21 21 21 21 21 18 21 25 25 25 34 15 16 34 34 34 34 34 15 15 15 15 15 15 15 15 24 23 25 25
25 25 25 25 25 25 25 25 25 25 25 25 25 25 25 25 25 25 25 25 25 25 14 14 14 14 17 17 17 14 14 14 25 25 25 25 25 25 14 14 17 17 14 14 14 14 14 14 25 25 25 25 25 25 25 25 25 14 19 19 21 18 21 21 21 21 21 21 18 18 21 18 18 18 21 18 21 25 25 25 34 16 16 34 34 34 34 24 15 15 34 34 34 34 15 15 15 23 25 25
25 25 25 25 25 25 25 25 25 25 25 25 25 25 25 25 25 25 25 25 25 25 25 25 14 14 14 14 17 17 14 14 14 25 25 25 25 14 14 17 17 17 14 14 14 14 25 25 25 25 25 25 25 25 25 25 14 14 19 19 21 18 18 21 18 18 18 18 18 18 21 18 18 18 21 18 21 25 25 25 34 16 15 15 34 15 15 15 15 34 34 34 34 15 15 15 23 23 23 25
25 25 25 25 25 25 25 25 25 25 25 25 25 25 25 25 25 25 25 25 25 25 25 25 14 14 14 14 14 17 17 14 14 14 25 25 14 14 17 17 17 14 14 25 25 25 25 25 25 25 25 25 25 25 25 14 14 14 19 19 21 18 18 21 18 18 21 21 21 18 21 18 21 21 21 18 21 25 25 25 34 15 15 15 15 15 15 15 34 34 15 16 16 15 15 23 15 24 23 23
25 25 25 25 25 25 25 25 25 25 25 25 25 25 25 25 25 25 25 25 25 25 25 25 25 25 14 14 14 14 17 17 14 14 14 14 14 17 17 17 14 14 25 25 25 25 25 25 25 25 25 25 25 25 25 14 14 19 19 19 21 18 18 21 18 18 21 18 18 21 21 18 21 18 18 18 21 25 25 25 34 15 34 34 34 34 15 15 34 15 16 16 23 23 23 15 16 15 15 23
25 25 25 25 25 25 25 25 25 25 25 25 25 25 25 25 25 25 25 25 25 25 25 25 25 25 25 25 14 14 14 17 17 14 14 14 17 17 17 14 14 14 25 25 25 25 25 25 25 25 25 25 25 25 14 14 14 19 19 19 21 21 21 21 18 18 21 18 18 18 18 18 21 18 18 18 21 25 25 25 34 15 16 15 24 34 15 15 34 34 15 15 15 15 15 16 16 15 15 23
25 25 25 25 25 25 25 25 25 25 25 25 25 25 25 25 25 25 25 25 25 25 25 25 25 25 25 25 25 14 14 14 17 17 14 17 17 14 14 14 25 25 25 25 25 25 25 25 25 25 25 25 25 14 14 14 19 19 19 19 21 18 18 18 18 21 21 18 18 21 18 18 18 18 18 18 21 25 25 25 25 34 16 16 15 34 15 16 16 34 34 34 15 15 16 16 24 23 23 23
25 25 25 25 25 25 25 25 25 25 25 25 25 25 25 25 25 25 25 25 25 25 25 25 25 25 25 25 25 25 14 14 14 17 17 17 14 14 25 25 25 25 25 25 25 25 25 25 25 25 25 25 14 14 14 14 19 19 19 25 21 18 18 21 18 18 21 18 18 21 18 21 21 21 21 21 21 25 25 25 25 34 15 15 15 34 24 15 15 15 16 34 34 34 15 15 23 15 15 23
25 25 25 25 25 25 25 25 25 25 25 25 25 25 25 25 25 25 25 25 25 25 25 25 25 25 25 25 25 25 25 14 25 17 17 14 14 25 25 25 25 25 25 25 25 25 25 25 25 25 14 14 14 14 19 19 19 19 14 14 21 21 21 21 18 18 21 18 18 21 18 18 18 18 18 18 21 25 25 25 25 25 34 34 34 34 34 15 15 16 16 15 15 34 34 15 15 15 15 23
14 14 14 14 14 14 14 25 25 25 25 25 25 25 25 25 25 25 25 25 25 25 25 25 25 25 25 25 25 25 25 25 17 17 14 14 25 25 25 25 25 25 25 25 25 25 25 25 14 14 14 14 14 19 19 19 19 14 14 14 21 18 18 18 18 18 21 18 18 21 18 18 18 21 18 18 21 25 25 25 25 25 25 25 25 25 34 34 34 34 34 34 15 15 34 34 34 34 23 23
18 18 18 18 18 18 14 14 14 14 25 25 25 25 25 25 25 25 25 25	25 25 25 25 25 25 25 25 25 25 25 17 17 14 14 25 25 25 25 25 25 25 25 25 25 14 14 14 14 14 14 14 19 19 19 19 14 14 14 14 21 21 21 19 19 21 21 21 21 21 21 21 21 21 18 18 21 25 25 25 25 25 25 25 25 25 14 14 14 14 14 17 17 17 17 17 14 14 25 25
18 18 18 19 19 19 18 18 14 14 14 14 14 25 25 25 25 25 25 25 25 25 25 14 25 25 25 25 25 25 25 17 17 14 14 25 25 25 25 25	25 25 25 14 14 14 14 14 14 14 19 19 19 19 19 19 14 14 14 25 21 14 21 19 19 21 25 25 25 25 25 14 14 17 17 17 14 14 14 14 25 25 25 25 25 14 14 14 14 14 14 17 17 17 17 14 14 14 25 25
18 18 19 19 19 19 19 18 18 18 18 18 14 14 14 14 14 14 14 14 14 14 14 14 14 14 14 14 14 25 17 17 14 14 14 14 14 14 14 14 14 14 14 14 14 14 14 14 19 19 19 19 19 19 14 14 14 14 14 14 14 14 21 19 19 21 25 25 25 25 25 25 14 17 17 17 17 14 14 14 14 25 25 14 14 14 14 14 14 14 17 17 17 17 14 14 25 14 25 25
18 19 19 19 19 19 19 19 19 19 18 25 14 14 14 14 14 14 14 14 14 14 14 14 14 14 14 25 25 17 17 14 14 14 14 14 14 14 14 14 14 14 14 14 14 14 19 19 19 19 19 19 19 14 14 14 14 14 25 25 25 25 21 19 19 21 25 25 25 25 25 25 14 14 25 17 17 17 14 14 14 14 14 14 14 14 14 14 14 17 17 17 17 14 14 13 25 13 14 25
18 19 19 19 19 19 19 19 19 19 19 19 19 14 14 19 19 19 19 19 19 19 19 19 19 19 19 19 19 19 19 19 19 19 19 14 14 14 14 14 14 14 14 14 19 19 19 19 19 19 14 14 14 14 14 14 14 25 25 25 25 25 21 19 19 21 25 25 25 25 25 25 25 14 14 17 17 17 17 14 14 14 14 14 14 14 14 17 17 17 17 17 14 14 13 17 25 17 13 25
18 19 19 19 19 19 19 19 19 19 19 19 19 19 19 19 19 19 19 19 19 19 19 19 19 19 19 19 19 19 19 19 19 19 19 19 19 19 19 19 19 19 19 19 19 19 19 19 14 14 14 14 14 14 14 25 25 25 25 25 25 21 21 19 19 21 21 25 25 25 25 25 25 25 14 14 13 17 17 17 17 14 14 14 14 17 17 17 17 17 17 17 17 17 17 17 17 17 17 25
18 19 19 19 19 19 19 19 19 19 19 19 19 19 19 19 19 19 19 19 19 19 19 19 19 19 19 19 19 19 19 19 19 19 19 19 19 19 19 19 19 19 19 19 19 19 14 14 14 14 14 14 14 25 25 25 25 25 25 25 25 21 19 19 19 19 21 25 25 25 25 25 25 25 25 14 14 13 17 17 17 17 17 17 17 17 17 17 17 17 17 17 17 17 17 17 17 17 17 25
25 14 19 19 19 19 19 19 19 14 14 14 14 14 14 19 19 19 19 19 19 14 14 14 14 14 14 14 14 14 14 19 19 19 19 19 19 19 19 19 19 19 19 14 14 14 14 14 14 14 14 25 25 25 25 25 25 25 25 25 25 21 19 18 18 19 21 25 25 25 25 25 25 25 25 25 14 14 13 17 17 17 17 17 17 17 17 25 25 13 13 13 13 13 13 17 17 17 17 25
14 25 14 19 19 19 14 14 14 25 25 25 25 25 25 14 14 14 14 14 14 25 25 25 25 25 14 14 14 14 14 14 14 14 14 14 14 14 14 14 14 14 14 14 14 14 14 14 14 25 25 25 25 25 25 25 25 25 25 25 25 21 21 19 19 21 21 25 25 25 25 25 25 25 25 25 25 14 14 25 25 17 17 17 17 17 25 25 14 14 14 14 14 14 25 25 14 13 25 25
14 14 14 14 14 14 14 14 25 25 25 25 25 25 25 25 25 25 14 14 25 25 25 25 25 25 25 25 25 25 25 25 25 25 25 25 14 25 14 14 14 14 14 14 14 25 25 25 25 25 25 25 25 25 25 25 25 25 25 25 25 25 21 21 21 21 25 25 25 25 25 25 25 25 25 25 25 25 14 14 14 25 25 25 25 25 14 14 14 14 14 25 25 25 25 25 25 25 25 25